...##
..##.#.####
.##..###..#
##...#....#
#...@..#..#
####.###..#
..#..#..#.#
.##.##.#.##
.#......##
.#..#..##
.###.###